"filename", "language", "JSON", "JavaScript", "Markdown", "Vue", "HTML", "comment", "blank", "total"
"d:\at\twtat\README.md", "Markdown", 0, 0, 26, 0, 0, 0, 8, 34
"d:\at\twtat\babel.config.js", "JavaScript", 0, 5, 0, 0, 0, 0, 1, 6
"d:\at\twtat\package-lock.json", "JSON", 12037, 0, 0, 0, 0, 0, 1, 12038
"d:\at\twtat\package.json", "JSON", 52, 0, 0, 0, 0, 0, 1, 53
"d:\at\twtat\public\index.html", "HTML", 0, 0, 0, 0, 16, 1, 1, 18
"d:\at\twtat\src\App.vue", "Vue", 0, 0, 0, 34, 0, 0, 8, 42
"d:\at\twtat\src\api\admin.js", "JavaScript", 0, 8, 0, 0, 0, 0, 1, 9
"d:\at\twtat\src\api\user.js", "JavaScript", 0, 208, 0, 0, 0, 0, 28, 236
"d:\at\twtat\src\components\admin\adminHome.vue", "Vue", 0, 0, 0, 302, 0, 0, 21, 323
"d:\at\twtat\src\components\admin\adminMain.vue", "Vue", 0, 0, 0, 162, 0, 1, 21, 184
"d:\at\twtat\src\components\cloudHeader.vue", "Vue", 0, 0, 0, 42, 0, 0, 6, 48
"d:\at\twtat\src\components\grouper.vue", "Vue", 0, 0, 0, 477, 0, 0, 43, 520
"d:\at\twtat\src\components\home.vue", "Vue", 0, 0, 0, 667, 0, 0, 53, 720
"d:\at\twtat\src\components\main.vue", "Vue", 0, 0, 0, 192, 0, 10, 22, 224
"d:\at\twtat\src\components\messagePage.vue", "Vue", 0, 0, 0, 24, 0, 0, 1, 25
"d:\at\twtat\src\components\projDetail.vue", "Vue", 0, 0, 0, 328, 0, 0, 32, 360
"d:\at\twtat\src\components\projDetailLog.vue", "Vue", 0, 0, 0, 74, 0, 0, 9, 83
"d:\at\twtat\src\components\projDetailMem.vue", "Vue", 0, 0, 0, 518, 0, 0, 37, 555
"d:\at\twtat\src\components\projDetailTask.vue", "Vue", 0, 0, 0, 295, 0, 0, 25, 320
"d:\at\twtat\src\components\projMain.vue", "Vue", 0, 0, 0, 386, 0, 2, 25, 413
"d:\at\twtat\src\components\project.vue", "Vue", 0, 0, 0, 174, 0, 0, 15, 189
"d:\at\twtat\src\components\userDetail.vue", "Vue", 0, 0, 0, 497, 0, 0, 36, 533
"d:\at\twtat\src\components\weeklyAll.vue", "Vue", 0, 0, 0, 456, 0, 0, 45, 501
"d:\at\twtat\src\components\weeklyWrite.vue", "Vue", 0, 0, 0, 196, 0, 10, 12, 218
"d:\at\twtat\src\main.js", "JavaScript", 0, 13, 0, 0, 0, 0, 4, 17
"d:\at\twtat\src\router\index.js", "JavaScript", 0, 91, 0, 0, 0, 1, 13, 105
"d:\at\twtat\src\store\getters.js", "JavaScript", 0, 9, 0, 0, 0, 0, 1, 10
"d:\at\twtat\src\store\index.js", "JavaScript", 0, 16, 0, 0, 0, 0, 6, 22
"d:\at\twtat\src\store\modules\admin.js", "JavaScript", 0, 12, 0, 0, 0, 0, 9, 21
"d:\at\twtat\src\store\modules\user.js", "JavaScript", 0, 97, 0, 0, 0, 0, 6, 103
"d:\at\twtat\src\utils\auth.js", "JavaScript", 0, 14, 0, 0, 0, 0, 5, 19
"d:\at\twtat\src\utils\request.js", "JavaScript", 0, 70, 0, 0, 0, 1, 6, 77
"d:\at\twtat\src\views\404.vue", "Vue", 0, 0, 0, 10, 0, 0, 3, 13
"d:\at\twtat\src\views\adminLogin.vue", "Vue", 0, 0, 0, 133, 0, 0, 16, 149
"d:\at\twtat\src\views\login.vue", "Vue", 0, 0, 0, 139, 0, 0, 15, 154
"d:\at\twtat\vue.config.js", "JavaScript", 0, 11, 0, 0, 0, 0, 0, 11
"Total", "-", 12089, 554, 26, 5106, 16, 26, 536, 18353